C 127,127,255
NO ./mandatory/xpm_file/tr_flag.xpm
SO ./mandatory/xpm_file/oe_flag.xpm
F 255,0,255
EA ./mandatory/xpm_file/sel_flag.xpm
WE ./mandatory/xpm_file/go_flag.xpm



111111111111111111111111111111
11000001100111111100000001111111
 11111111110000011111111100000111
      11100001100011 110001000001
     1111011110001111100011001001
     1111001000000001000010010001
111111111111000001000000111000011
10000000001100000111011110000011
1111011111111101110000000000111
  10111100011110000000000011111
1110000011010101100000000100111
100000000000000011100000111111
10000000N00000001101001000001
110000011101010111111111100011111
11110111 1110100000000000000011
   11111 11111111111111111111111
