NO ./bonus/xpm_file/wall.xpm
SO ./bonus/xpm_file/wall.xpm
F 0,255,255


EA ./bonus/xpm_file/wall.xpm

D ./bonus/xpm_file/door.xpm

WE ./bonus/xpm_file/wall.xpm

C 127,127,255


111111111111111111111111111111
11100001100111111100000001111111
 11111111110000011111111100000111
      1110000110001  110001000101
  1111111011110001111100011001001
     1  1001000000001000010010001
111111111111000001000000111100011
10000000001100000111D111100000111
110101111111110111000000000011111
1101111100011110000000000011111
11D100001101010D1000N0000100111
100100000000000011100001D11111
1D110000000000001101001000001
100000011101010111111111100011111
11110111 111D10110D0D0101000D1
   11111 11101111110101110111111
           10111111010D0001
           1000D00001111111
           1111111111
