NO ./bonus/xpm_file/tr_flag.xpm
SO ./bonus/xpm_file/oe_flag.xpm
F 255,0,255

D ./bonus/xpm_file/door.xpm

EA ./bonus/xpm_file/sel_flag.xpm


WE ./bonus/xpm_file/go_flag.xpm

C 127,127,255

111111111111111111111111111111111111111111111111111111111
100000000000000000000000000000000000000000000000000000001
100000000000000000000000000000000000000000000000000000001
100000000000000000000000000000000000000000000000000000001
100000000000000000000000000000000000000000000000000000001
100000000000000000000000000000000000000000000000000000001
1000000000000000DDDDDDDDDDDDDDDDDDDDDDDDD0000000000000001
1000000000000000D00000000000000000000000D0000000000000001
1000000000000000D00000000000000000000000D0000000000000001
1000000000000000D00000000000000000000000D0000000000000001
1000000000000000D00000000000000000000000D0000000000000001
1000000000000000D00000000000000000000000D0000000000000001
1000000000000000D00000000000100000000000D0000000000000001
1000000000000000D00000000000000000000000D0000000000000001
1000000000000000D0000000000000N000000000D0000000000000001
1000000000000000D00000000000000000000000D0000000000000001
1000000000000000D00000000000000000000000D0000000000000001
1000000000000000D00000000000000000000000D0000000000000001
1000000000000000DDDDDDDDDDDDDDDDDDDDDDDDD0000000000000001
100000000000000000000000000000000000000000000000000000001
100000000000000000000000000000000000000000000000000000001
100000000000000000000000000000000000000000000000000000001
100000000000000000000000000000000000000000000000000000001
100000000000000000000000000000000000000000000000000000001
100000000000000000000000000000000000000000000000000000001
100000000000000000000000000000000000000000000000000000001
100000000000000000000000000000000000000000000000000000001
100000000000000000000000000000000000000000000000000000001
100000000000000000000000000000000000000000000000000000001
100000000000000000000000000000000000000000000000000000001
100000000000000000000000000000000000000000000000000000001
100000000000000000000000000000000000000000000000000000001
111111111111111111111111111111111111111111111111111111111
