1111111111
1000C00001
1010110101
1E10C001P1
1111111111
