1111111111111
1001000S000C1
1000011110001
1P0011E000S01
1111111111111
