1111111111111111111111111111111111
1E000000S0000000C0000C000000000001
1010010100100S00101001000000010101
1010010010101010001001000000010101
1P0000000C00C0000000000000S00000C1
1111111111111111111111111111111111
