1111111111
1000C00001
1010110101
1E10CS01P1
1111111111
