11111111111111111
1P0000000C0000001
11111111111111101
1000000000C000001
10111111111111111
1010000SC00C001E1
10C01000100010001
11111111111111111
