1111111111111111111111
10001CC00000001000SCC1
10101CC011111010100CC1
10100S0010P01000100001
1011111110001111111101
101CC0000101C0C1000101
101CC00101010E01010101
10000S010001C0C0010001
1111111111111111111111
